alarm - Sets reminders and timer
A module to set Alarms in Enlightenment 17. It repaces eveil.
[A] Laurent 'kiwi' Ghigonis
[L] GPL

# bling - EFLized Composite Manager for E17. (Not for users right now).
    
calendar - A module to show the current day.
New calendar module: Does currently show a calendar sheet in the shelf, will
be extended by a month view popup and maybe later by plugins to allow
accessing apps like evolution.
[A] Brian 'morlenxus' Miculcy <morlenxus@gmx.net>
[L] BSD

cpu - A module to monitor cpu load
A module to monitor cpu load. Separated from old monitor module.
[A] Matthew Mullins {original author}
[A] Christopher 'devilhorns' Michael <devilhorns@comcast.net>

deskshow - shows the desktop 
A module to iconify/uniconify all current windows to show the
desktop.  This is probably obsolete, the functionality is now in E.
	
diskio - visualize disk i/o.

drawer - shows various types of information
A drawer module, which is/will be able to present different types of
information.
[A] Viktor 'urandom' Kojouharov     <vkojouharov@gmail.com>
[L] BSD
	
emu - Experimental generic scriptable module for E17.
	
exalt-client - A frontend module for exalt network manager.
	
flame - A module to display flames on the desktop.
	
forecasts - A module to display the current condition and forecasts.
	
language - modifies the keybourd settings
A module to control active keyboard/keyboard layout/layout variant.
	      
mail - A module to periodically check for new email.
	      
mem - A module to monitor memory and swap usage.

moon - A module to display moon phase information.
	 
mpdule - A module to display what's playing in MPD.
	 
net - A module to monitor traffic on a network device.
	 
news - A module to display rss feeds.
	 
penguins - A module to display fancy penguins on your desktop.
	 
photo - A module to display pictures on the desktop.
	 
places - manage volumes attached to the system.
	 
rain - A module to display rain on the desktop.
	 
screenshot - A module to take screenshots, utilizing scrot or import.
	 
slideshow - A module to cycle desktop backgrounds.
	 
snow - A module to display snow on the desktop.
	 
taskbar - A taskbar module.

tclock - A module to display a digital clock on the desktop.

uptime - A module to monitor computer uptime.
 
weather - A module to display a weather forecast.
 
winselector - A module to show menu-based access to open windows.
 
wlan - A module to monitor a wlan device.
